a	xs
o	xl
e	xe
ai	xh
ao	xz
an	xf
ang	xp
ou	xd
ei	xw
er	xj
en	xn
eng	xr
ba	bs
bo	bl
bi	bk
bu	bj
bai	bh
bao	bz
ban	bf
bang	bp
bei	bw
ben	bn
beng	br
biao	bc
bian	bm
bie	bd
bin	bb
bing	bg
pa	ps
po	pl
pi	pk
pu	pj
pai	ph
pao	pz
pan	pf
pang	pp
pou	pd
pei	pw
pen	pn
peng	pr
piao	pc
pian	pm
pie	pd
pin	pb
ping	pg
ma	ms
mo	ml
me	me
mi	mk
mu	mj
mai	mh
mao	mz
man	mf
mang	mp
mou	md
mei	mw
men	mn
meng	mr
miao	mc
mian	mm
mie	md
miu	mq
min	mb
ming	mg
fa	fs
fo	fl
fu	fj
fan	ff
fang	fp
fou	fd
fei	fw
fen	fn
feng	fr
da	ds
de	de
di	dk
du	dj
dai	dh
dao	dz
dan	df
dang	dp
dou	dd
dong	dy
dei	dw
den	dn
deng	dr
dia	ds
diao	dc
dian	dm
die	dd
diu	dq
ding	dg
duan	dt
dui	db
dun	dw
duo	dl
ta	ts
te	te
ti	tk
tu	tj
tai	th
tao	tz
tan	tf
tang	tp
tou	td
tong	ty
teng	tr
tiao	tc
tian	tm
tie	td
ting	tg
tuan	tt
tui	tb
tun	tw
tuo	tl
na	ns
ne	ne
ni	nk
nu	nj
nv	nl
n端	nl
nai	nh
nao	nz
nan	nf
nang	np
nou	nd
nong	ny
nei	nw
nen	nn
neng	nr
niao	nc
nian	nm
nie	nd
niu	nq
nin	nb
ning	ng
niang	nx
nuan	nt
n端e	nh
nue	nh
nve	nh
nun	nw
nuo	nl
la	ls
lo	ll
le	le
li	lk
lu	lj
lv	ll
l端	ll
lai	lh
lao	lz
lan	lf
lang	lp
lou	ld
long	ly
lei	lw
leng	lr
lia	ls
liao	lc
lian	lm
lie	ld
liu	lq
lin	lb
ling	lg
liang	lx
luan	lt
lue	lh
lve	lh
l端e	lh
lun	lw
luo	ll
ga	gs
ge	ge
gu	gj
gai	gh
gao	gz
gan	gf
gang	gp
gou	gd
gong	gy
gei	gw
gen	gn
geng	gr
gua	gq
guai	gg
guan	gt
guang	gx
gui	gb
gun	gw
guo	gl
ka	ks
ke	ke
ku	kj
kai	kh
kao	kz
kan	kf
kang	kp
kou	kd
kong	ky
kei	kw
ken	kn
keng	kr
kua	kq
kuai	kg
kuan	kt
kuang	kx
kui	kb
kun	kw
kuo	kl
ha	hs
he	he
hu	hj
hai	hh
hao	hz
han	hf
hang	hp
hou	hd
hong	hy
hei	hw
hen	hn
heng	hr
hua	hq
huai	hg
huan	ht
huang	hx
hui	hb
hun	hw
huo	hl
ji	jk
ju	jl
jv	jl
jia	js
jiao	jc
jian	jm
jie	jd
jiu	jq
jin	jb
jing	jg
jiang	jx
jiong	jy
juan	jt
jue	jh
jun	jw
qi	qk
qu	ql
qv	ql
qia	qs
qiao	qc
qian	qm
qie	qd
qiu	qq
qin	qb
qing	qg
qiang	qx
qiong	qy
quan	qt
que	qh
qun	qw
xi	xk
xu	xl
xv	xl
xia	xs
xiao	xc
xian	xm
xie	xd
xiu	xq
xin	xb
xing	xg
xiang	xx
xiong	xy
xuan	xt
xue	xh
xun	xw
zha	fs
zhe	fe
zhi	fk
zhu	qj
zhai	qh
zhao	qz
zhan	qf
zhang	qp
zhou	fd
zhong	fy
zhei	qw
zhen	qn
zheng	qr
zhua	fq
zhuai	fg
zhuan	ft
zhuang	fx
zhuang	fm
zhui	fb
zhun	qw
zhuo	fl
cha	ws
che	we
chi	wk
chu	jj
chai	jh
chao	jz
chan	jf
chang	jp
chou	wd
chong	wy
chen	jn
cheng	jr
chuai	wg
chuan	wt
chuang	wx
chuang	wm
chui	wb
chun	jw
chuo	wl
sha	es
she	ee
shi	ek
shu	ej
shai	eh
shao	ez
shan	ef
shang	ep
shou	ed
shei	ew
shen	en
sheng	er
shua	eq
shuai	eg
shuan	et
shuang	ex
shuang	em
shui	eb
shun	ew
shuo	el
re	re
ri	rk
ru	rj
rao	rz
ran	rf
rang	rp
rou	rd
rong	ry
ren	rn
reng	rr
ruan	rt
rui	rb
run	rw
ruo	rl
za	zs
ze	ze
zi	zk
zu	zj
zai	zh
zao	zz
zan	zf
zang	zp
zou	zd
zong	zy
zei	zw
zen	zn
zeng	zr
zuan	zt
zui	zb
zun	zw
zuo	zl
ca	cs
ce	ce
ci	ck
cu	cj
cai	ch
cao	cz
can	cf
cang	cp
cou	cd
cong	cy
cen	cn
ceng	cr
cuan	ct
cui	cb
cun	cw
cuo	cl
sa	ss
se	se
si	sk
su	sj
sai	sh
sao	sz
san	sf
sang	sp
sou	sd
song	sy
sen	sn
seng	sr
suan	st
sui	sb
sun	sw
suo	sl
ya	ys
yo	yl
yi	yk
yu	yl
yv	yl
yao	yz
yan	yf
yang	yp
you	yd
yong	yy
ye	ye
yin	yb
ying	yg
yuan	yt
yue	yh
yun	yw
wa	ws
wo	wl
wu	wj
wai	wh
wan	wf
wang	wp
wei	ww
wen	wn
weng	wr